local HttpService = game:GetService("HttpService")
local RunService = game:GetService("RunService")
local RS = game:GetService("ReplicatedStorage")
local Players = game:GetService("Players")
local Workspace = game:GetService("Workspace")
local VIM = game:GetService("VirtualInputManager")
local VirtualUser = game:GetService("VirtualUser")
local LocalPlayer = Players.LocalPlayer
local RemoteFunction = RS.Shared.Framework.Network.Remote:WaitForChild("RemoteFunction")
local RemoteEvent = RS.Shared.Framework.Network.Remote:WaitForChild("RemoteEvent")
local Remote = require(RS.Shared.Framework.Network.Remote)
local RiftsModule = require(RS.Shared.Data.Rifts)
local Powerups=require(RS.Shared.Data.Powerups)
local PotionsModule = require(RS.Shared.Data.Potions)
local ShrineValues = require(RS.Shared.Data.ShrineValues)
local GumData = require(RS.Shared.Data.Gum)
local BoardUtil = require(RS.Shared.Utils.BoardUtil)
local ShopUtil=require(RS.Shared.Utils.ShopUtil)
local ShopsData=require(RS.Shared.Data.Shops)
local minigamesModule=require(RS.Shared.Data.Minigames)
local EnchantsModule = require(RS.Shared.Data.Enchants)
local petsModule = require(RS.Shared.Data.Pets)
local eggsModule = require(RS.Shared.Data.Eggs)
local secretBountyUtil = require(RS.Shared.Utils.Stats.SecretBountyUtil)
local Board = require(RS.Client.Gui.Frames.Board)
local HatchEggModule=require(RS.Client.Effects.HatchEgg)
local PhysicalItem = require(RS.Client.Effects.PhysicalItem)
local QuestUtil = require(RS.Shared.Utils.Stats.QuestUtil)
local TimeUtil = require(RS.Shared.Framework.Utilities.Math.Time)
local Constants = require(RS.Shared.Constants)
local humanoidRootPart = LocalPlayer.Character and LocalPlayer.Character:WaitForChild("HumanoidRootPart")
local LocalData = require(RS.Client.Framework.Services.LocalData)
local playerData = LocalData:Get()
playerData.UserId=LocalPlayer.UserId

local Library = loadstring(game:HttpGetAsync("https://github.com/ActualMasterOogway/Fluent-Renewed/releases/latest/download/Fluent.luau"))()
local SaveManager = loadstring(game:HttpGetAsync("https://raw.githubusercontent.com/ActualMasterOogway/Fluent-Renewed/master/Addons/SaveManager.luau"))()
local InterfaceManager = loadstring(game:HttpGetAsync("https://raw.githubusercontent.com/ActualMasterOogway/Fluent-Renewed/master/Addons/InterfaceManager.luau"))()

getgenv().RiftsConfig={SelectedEgg=nil,AutoHatch=false,DisableEggAnim=false,SelectedEggRift=nil,SelectedChestRift=nil,IgnoreMultiplier={},TeleportEggRift=false,TeleportChestRift=false}

local player = Players.LocalPlayer
if not player then return end

local enabled = true
local clicks = 0

local function antiAfk()
    if not enabled then return end
    VirtualUser:CaptureController()
    VirtualUser:ClickButton2(Vector2.new(0,0))
    clicks += 1
end

player.Idled:Connect(function()
    antiAfk()
end)

local Window = Library:CreateWindow{
    Title = "OTC v1.1",
    SubTitle = "by aerlro",
    TabWidth = 140,
    Size = UDim2.fromOffset(650, 400),
    MinSize = Vector2.new(400, 320),
    Acrylic = true,
    Theme = "Darker",
    MinimizeKey = Enum.KeyCode.RightControl
}

local Tabs = {
    Home = Window:CreateTab{ Title = "Home", Icon = "rbxassetid://96624083086513" },
    Aerlro = Window:CreateTab{ Title = "Aerlro", Icon = "rbxassetid://140431377231411" },
    Christmas = Window:CreateTab{ Title = "Christmas", Icon = "phosphor-snowflake-bold" },
    Settings = Window:CreateTab{ Title = "Settings", Icon = "settings" }
}

local Player = Players.LocalPlayer
local function teleportTo(pos)
    local char = Player.Character or Player.CharacterAdded:Wait()
    local hrp = char:FindFirstChild("HumanoidRootPart")
    if hrp then
        hrp.CFrame = CFrame.new(pos)
    else
        warn("⚠️ No HumanoidRootPart found.")
    end
end

local autoPressE=false;local EggRiftMap,ChestRiftMap={},{}
for id,data in pairs(RiftsModule)do if data.Type=="Egg"then EggRiftMap[id]=data.Egg or data.DisplayName or id elseif data.Type=="Chest"then ChestRiftMap[id]=data.DisplayName or id end end
local teleportedEggs,alreadyTeleported={},{}
local EggsSection=Tabs.Aerlro:CreateSection("▶ Eggs")
local RS=game:GetService("ReplicatedStorage")
local VIM=game:GetService("VirtualInputManager")
local LP=game:GetService("Players").LocalPlayer
local HatchEggModule=RS:FindFirstChild("Client")and RS.Client:FindFirstChild("Effects")and RS.Client.Effects:FindFirstChild("HatchEgg")and require(RS.Client.Effects.HatchEgg)
local oldPlay=HatchEggModule and HatchEggModule.Play or nil
if HatchEggModule and oldPlay then HatchEggModule.Play=function(...)if getgenv().RiftsConfig.DisableEggAnim then return end return oldPlay(...) end end
local function getEggList()local n,s={},{} local f=workspace:WaitForChild("Rendered"):GetChildren()[13] if f then for _,e in pairs(f:GetChildren())do local name=e.Name if name and not s[name] and not name:find("Coming Soon") then table.insert(n,name) s[name]=true end end end table.sort(n) return n end
EggsSection:CreateDropdown("EggSelect",{Title="Eggs",Values=getEggList(),Default=nil,Callback=function(v)getgenv().RiftsConfig.SelectedEgg=v teleportedEggs[v]=false end})
local disT=EggsSection:CreateToggle("DisableEggAnim",{Title="Disable Egg Animation",Default=false})
disT:OnChanged(function(v)getgenv().RiftsConfig.DisableEggAnim=v end)
local function teleportToEgg(e)local hrp=LP.Character and LP.Character:FindFirstChild("HumanoidRootPart") if not hrp then return end local rendered=workspace:WaitForChild("Rendered"):GetChildren()[13] if not rendered then return end local eggModel=rendered:FindFirstChild(e) if not eggModel then return end local safePoint local deco=eggModel:FindFirstChild("Decoration") if deco and deco:FindFirstChild("Primary") then local primary=deco.Primary local g=primary:GetChildren()[9] if g and g:IsA("BasePart") then safePoint=g end end if safePoint and not alreadyTeleported[e] then hrp.CFrame=safePoint.CFrame+Vector3.new(0,3,0) teleportedEggs[e]=true alreadyTeleported[e]=true end getgenv().RiftsConfig.LastPosition=hrp.CFrame end
EggsSection:CreateToggle("TeleportSummonedEgg",{Title="Teleport to Summoned Egg",Default=false,Callback=function(v)getgenv().RiftsConfig.TeleportSummonedEgg=v if v then task.spawn(function() local wasSummoned=false while getgenv().RiftsConfig.TeleportSummonedEgg do local hrp=LP.Character and LP.Character:FindFirstChild("HumanoidRootPart") local summoned=workspace:FindFirstChild("SummonedEgg") local selectedEgg=getgenv().RiftsConfig.SelectedEgg if summoned and summoned:FindFirstChild("EggPlatformSpawn") then wasSummoned=true if not alreadyTeleported["SummonedEgg"] then local p=summoned.EggPlatformSpawn.PrimaryPart or summoned.EggPlatformSpawn:FindFirstChildWhichIsA("BasePart") if p and hrp then hrp.CFrame=p.CFrame+Vector3.new(0,3,0) alreadyTeleported["SummonedEgg"]=true alreadyTeleported[selectedEgg]=false end end elseif wasSummoned then wasSummoned=false alreadyTeleported["SummonedEgg"]=false if selectedEgg then alreadyTeleported[selectedEgg]=false teleportToEgg(selectedEgg) end end task.wait(1) end end) end end})
EggsSection:CreateToggle("AutoHatchEggs",{Title="Auto Hatch",Default=false,Callback=function(v)getgenv().RiftsConfig.AutoHatch=v if v then getgenv().autoPressE=true task.spawn(function() while getgenv().autoPressE do VIM:SendKeyEvent(true,Enum.KeyCode.E,false,game) task.wait() VIM:SendKeyEvent(false,Enum.KeyCode.E,false,game) task.wait() end end) task.spawn(function() while getgenv().RiftsConfig.AutoHatch do local egg=getgenv().RiftsConfig.SelectedEgg if egg and (not getgenv().RiftsConfig.TeleportSummonedEgg or not workspace:FindFirstChild("SummonedEgg")) then teleportToEgg(egg) end task.wait(1.5) end end) else getgenv().autoPressE=false end end})
local RiftsSection=Tabs.Aerlro:CreateSection("▶ Rifts") RiftsSection:CreateDropdown("EggRiftSelect",{Title="Egg Rifts",Values=(function()local t={}for _,v in pairs(EggRiftMap)do table.insert(t,v)end table.sort(t)return t end)(),Multi=false,Default=nil,Callback=function(v)for k,val in pairs(EggRiftMap)do if val==v then getgenv().RiftsConfig.SelectedEggRift=k break end end end}) RiftsSection:CreateDropdown("IgnoreMultiplier",{Title="Ignore Egg Rift Multipliers",Values={1,2,5,10,15,20,25},Multi=true,Default={},Callback=function(vals)local s={}for k,v in pairs(vals)do if v==true then local num=tonumber(k)if num then s[num]=true end end end getgenv().RiftsConfig.IgnoreMultiplier=s end}) RiftsSection:CreateToggle("TeleportEggRiftToggle",{Title="Teleport to Egg Rift",Default=false,Callback=function(v)getgenv().RiftsConfig.TeleportEggRift=v autoPressE=v if v then task.spawn(function()while autoPressE do VIM:SendKeyEvent(true,Enum.KeyCode.E,false,game) task.wait() VIM:SendKeyEvent(false,Enum.KeyCode.E,false,game) task.wait() end end) end end}) RiftsSection:CreateDropdown("ChestRiftSelect",{Title="Chest Rifts",Values=(function()local t={}for _,v in pairs(ChestRiftMap)do table.insert(t,v)end table.sort(t)return t end)(),Multi=false,Default=nil,Callback=function(v)for k,val in pairs(ChestRiftMap)do if val==v then getgenv().RiftsConfig.SelectedChestRift=k break end end end}) RiftsSection:CreateToggle("TeleportChestRiftToggle",{Title="Teleport to Chest Rift",Default=false,Callback=function(v)getgenv().RiftsConfig.TeleportChestRift=v autoPressE=v if v then task.spawn(function()while autoPressE do VIM:SendKeyEvent(true,Enum.KeyCode.E,false,game) task.wait() VIM:SendKeyEvent(false,Enum.KeyCode.E,false,game) task.wait() end end) end end}) local function getRiftMultiplier(r)for _,d in ipairs(r:GetDescendants())do if d:IsA("TextLabel")or d:IsA("TextBox")then local t=d.Text:lower() local m=t:match("(%d+)%s*x")or t:match("x%s*(%d+)") if m then return tonumber(m)end end end return nil end local function teleportTo(pos)local hrp=LocalPlayer.Character and LocalPlayer.Character:FindFirstChild("HumanoidRootPart")if hrp and pos then hrp.CFrame=CFrame.new(pos+Vector3.new(0,5,0))end end local alreadyTeleported={} RunService.Heartbeat:Connect(function() local cfg=getgenv().RiftsConfig for _,r in pairs(workspace:GetDescendants())do if r:IsA("Model")then local id=r:GetDebugId()or(r.Name..game.JobId) if alreadyTeleported[id]then continue end if cfg.TeleportEggRift and cfg.SelectedEggRift and r.Name==cfg.SelectedEggRift then local platform=r:FindFirstChild("EggPlatformSpawn") if platform then local part=platform.PrimaryPart or platform:FindFirstChildWhichIsA("BasePart") if part then local m=getRiftMultiplier(r) if not m or not cfg.IgnoreMultiplier[m]then teleportTo(part.Position) alreadyTeleported[id]=true end end end end if cfg.TeleportChestRift and cfg.SelectedChestRift and r.Name==cfg.SelectedChestRift then local part=r.PrimaryPart or r:FindFirstChildWhichIsA("BasePart") if part then teleportTo(part.Position) alreadyTeleported[id]=true end end end end end)
